30 17
100 100
4 0 0 0 0 0 0 0 0 0 0 0 0 0 0 0 0 0 0 0 0 0 0 0 0 0 0 0 0 5
3 1 1 1 1 1 1 1 6 1 1 1 1 1 1 1 1 1 1 1 1 1 1 1 1 1 1 1 1 6
3 1 1 1 1 1 1 1 6 1 1 1 1 1 1 1 1 1 1 1 1 1 6 1 1 1 1 1 1 6
3 1 1 1 1 1 1 1 1 1 1 1 1 1 1 1 1 1 1 1 1 1 6 1 1 1 1 1 1 6
3 7 7 7 7 7 7 7 7 1 1 1 1 1 1 1 1 1 1 1 1 1 6 1 1 1 1 1 1 6
3 1 1 1 1 1 1 1 1 1 1 1 1 1 1 1 1 1 1 1 1 4 0 0 0 0 0 0 0 6
3 1 1 1 1 1 1 1 1 1 1 1 1 1 1 1 1 1 1 1 1 3 1 1 1 1 1 1 1 6
3 0 0 0 0 0 0 0 5 1 1 1 1 1 1 1 1 1 1 1 1 3 1 1 1 1 1 1 1 6
3 1 1 1 1 1 1 1 6 1 1 1 1 1 1 1 1 1 1 1 1 3 1 1 1 1 1 1 1 6
3 1 1 1 1 1 1 1 6 1 1 1 1 1 1 1 1 1 1 1 1 3 1 1 1 1 1 1 1 6
3 1 1 1 1 1 1 1 6 1 1 1 1 1 1 1 1 1 1 1 1 3 1 1 1 1 1 1 1 6
3 1 1 1 1 1 1 1 6 1 1 1 1 1 1 1 1 1 1 1 1 3 1 1 1 1 1 1 1 6
3 1 1 1 1 1 1 1 6 1 1 1 1 1 1 1 1 1 1 1 1 3 1 1 1 1 1 1 1 6
3 1 1 1 1 1 1 1 6 1 1 1 1 1 1 1 1 1 1 1 1 9 7 7 7 1 7 7 7 6
3 1 1 1 1 1 1 1 6 1 1 1 1 1 1 1 1 1 1 1 1 1 1 1 1 1 1 1 1 6
3 1 1 1 1 1 1 1 1 1 1 1 1 1 1 1 1 1 1 1 1 1 1 1 1 1 1 1 1 6
9 7 7 7 7 7 7 7 7 7 7 7 7 7 7 7 7 7 7 7 7 7 7 7 7 7 7 7 7 8
